3 12 5 9 5 1 1 1 2 2 1 3 12 21 9 6 1 5 17 6 5 9 4 1 2 2 7 2 6 1 
5 3 2 3 2 1 1 1 1 1 2 7 12 10 13 9 4 6 18 5 3 2 3 2 4 4 3 3 4 10 
5 3 5 3 2 1 1 1 2 1 4 4 2 7 3 2 1 5 2 5 4 2 2 1 1 1 3 7 5 7 
5 4 4 1 1 1 1 1 4 1 0 1 0 1 2 1 1 2 3 3 4 4 2 1 0 0 4 9 6 3 
2 4 4 2 1 1 1 2 3 2 0 2 1 1 0 1 1 2 3 3 3 9 3 0 1 2 3 6 2 3 
3 5 3 6 2 3 1 2 4 3 1 1 1 1 1 0 1 6 3 4 5 11 4 2 3 2 2 3 1 0 
3 8 2 4 6 5 4 7 8 2 3 2 6 8 2 1 1 3 2 4 11 5 8 12 4 1 1 1 2 4 
8 7 2 3 4 6 7 6 7 2 4 6 19 10 3 4 7 5 3 1 4 5 7 6 5 2 1 2 6 9 
6 5 2 4 5 5 6 5 7 4 1 8 8 5 1 2 4 3 4 2 4 4 4 2 2 1 1 3 2 2 
5 5 3 5 5 2 2 5 3 3 6 6 17 6 4 5 2 3 1 3 2 6 10 7 1 1 1 1 3 4 
6 2 5 4 1 4 1 2 7 2 4 5 13 6 3 7 3 3 2 1 1 7 6 7 1 1 0 1 3 1 
3 10 7 7 4 2 0 1 4 6 1 1 4 2 3 3 4 1 2 1 4 10 2 3 1 0 1 3 1 3 
2 3 2 1 2 4 0 2 1 3 1 1 4 7 3 8 5 4 2 2 2 1 7 1 0 1 0 1 1 4 
1 0 1 3 6 3 1 0 1 1 1 2 2 3 6 8 7 3 1 2 1 3 3 2 2 3 1 2 3 4 
3 1 3 4 4 1 0 0 2 1 2 1 2 0 2 5 3 1 1 1 0 0 1 5 9 9 7 1 1 3 
2 2 1 2 3 1 2 1 2 2 2 2 1 2 2 5 3 1 1 1 1 0 2 1 5 10 6 1 3 3 
0 1 2 8 6 11 3 4 4 2 2 1 0 1 1 0 4 1 1 2 1 1 3 2 1 6 11 3 5 3 
2 1 8 7 11 11 1 2 1 3 5 1 2 0 2 1 0 1 1 5 4 2 1 2 1 7 22 8 8 8 
3 0 3 7 4 3 1 1 2 3 9 6 2 2 1 1 0 1 0 5 3 1 1 1 2 3 8 7 10 6 
2 0 1 6 2 4 1 3 3 6 5 4 3 1 1 1 1 1 0 7 4 1 3 2 1 1 1 4 9 4 
2 1 1 3 6 1 1 1 0 6 13 6 1 0 1 1 0 0 1 4 2 0 1 1 1 2 4 9 7 2 
4 4 4 3 5 1 0 2 1 5 7 2 1 0 0 0 1 0 2 2 2 1 1 4 1 2 8 5 5 3 
10 8 13 12 5 1 1 2 2 2 5 1 1 1 2 1 2 1 4 1 3 2 1 2 2 3 8 5 3 6 
9 8 3 2 5 2 1 0 3 7 5 9 2 2 3 1 1 1 1 2 1 0 1 1 1 6 5 3 3 5 
3 3 1 4 2 6 2 0 2 4 3 5 5 4 3 2 1 2 1 2 1 1 1 1 1 3 6 5 2 2 
1 1 4 2 2 5 1 1 1 2 6 12 5 9 3 5 6 3 2 1 1 1 1 0 1 4 5 5 1 1 
3 2 5 3 4 3 4 0 1 1 12 11 6 3 4 2 5 1 1 2 1 0 0 0 2 2 5 11 2 1 
2 5 6 4 4 5 6 3 3 3 4 4 1 3 8 3 3 3 6 2 1 1 1 0 1 1 2 2 2 1 
12 6 8 7 8 6 4 1 1 0 4 2 4 8 6 3 2 6 11 3 1 1 0 2 3 2 4 3 4 6 
5 14 8 10 4 3 3 4 2 2 1 0 5 8 22 5 2 5 5 8 2 5 6 2 2 2 3 4 3 9 
-----------------------------------------------
2 2 2 2 1 0 0 0 1 1 0 2 2 3 3 2 1 2 3 2 2 2 2 1 0 1 2 1 1 1 
1 2 1 1 1 0 0 0 0 0 1 3 2 2 3 2 1 2 3 2 1 1 1 1 1 1 2 1 1 2 
1 1 1 1 0 1 0 0 0 0 1 1 1 2 2 1 0 2 1 1 1 1 0 0 0 1 2 2 1 2 
1 1 1 0 1 1 0 1 1 1 0 0 0 0 0 1 0 1 1 1 1 1 0 0 0 0 1 2 2 1 
1 2 1 1 0 1 0 1 1 1 0 0 0 0 0 0 0 1 2 1 1 2 1 0 0 0 1 1 1 1 
1 2 1 2 1 1 0 1 2 1 0 0 0 0 0 0 0 1 1 1 2 2 1 1 1 1 1 1 0 0 
2 2 1 2 2 2 2 1 2 1 1 1 3 2 0 0 1 1 1 2 2 3 2 2 2 1 0 0 0 1 
2 2 1 2 2 1 2 2 2 1 1 2 3 2 1 1 2 1 1 1 1 2 2 2 1 1 0 1 2 2 
2 1 1 1 2 2 1 2 2 1 0 2 3 2 1 1 1 2 1 1 1 2 2 1 0 0 1 1 1 1 
1 1 1 2 1 1 0 1 2 1 2 2 3 2 2 2 1 1 1 1 1 2 2 2 1 1 0 0 1 1 
2 1 1 1 1 1 0 1 1 1 1 2 3 2 1 2 1 1 1 1 1 2 2 2 1 0 0 0 1 1 
1 2 1 2 1 1 0 0 1 2 0 1 2 1 1 1 1 1 1 0 1 2 2 1 0 0 0 1 1 1 
1 1 0 0 2 1 0 0 0 1 0 1 1 2 1 2 2 2 1 1 1 1 2 0 0 0 0 0 0 1 
0 0 0 1 2 1 0 0 0 1 0 1 1 1 2 2 2 2 1 1 0 1 1 1 1 1 1 1 1 1 
1 0 1 2 1 1 0 0 0 0 1 0 1 0 1 2 1 0 0 0 0 0 1 2 2 2 2 1 1 1 
1 1 0 1 1 1 1 1 0 0 1 0 0 1 0 2 1 0 0 0 0 0 0 0 1 2 2 1 1 1 
0 0 1 2 3 3 1 2 1 1 1 0 0 0 0 0 1 1 0 1 0 0 1 1 0 2 3 1 1 1 
1 0 2 3 4 2 1 1 1 1 2 0 0 0 0 0 0 0 1 1 1 1 0 0 0 2 3 3 3 2 
1 0 1 2 2 1 0 0 1 1 2 1 1 0 0 0 0 0 0 2 2 0 1 0 1 2 3 3 2 1 
1 0 1 1 1 1 0 1 1 1 1 2 1 1 0 0 0 0 0 2 1 1 1 1 0 1 1 1 2 2 
1 0 0 1 1 0 0 0 0 2 2 2 0 0 0 0 0 0 0 1 1 0 1 1 0 1 1 2 2 1 
2 1 1 2 1 0 0 1 0 2 2 1 1 0 0 0 0 0 1 1 1 0 0 1 0 1 2 2 1 1 
3 2 2 3 2 0 0 0 1 1 2 1 1 1 0 0 1 1 1 1 1 1 0 0 1 2 2 2 2 2 
2 2 1 1 1 1 0 0 1 2 2 2 1 0 1 1 0 1 0 1 1 0 0 0 0 1 1 2 1 1 
1 1 0 1 1 2 1 0 0 1 2 2 2 2 1 1 1 1 0 0 1 1 0 0 0 1 2 1 0 1 
0 0 1 1 1 2 1 0 0 1 1 2 2 2 1 1 1 1 1 0 0 0 0 0 0 1 2 2 0 0 
1 2 1 1 2 2 1 0 0 1 2 3 2 2 1 1 1 1 0 1 0 0 0 0 1 1 2 2 0 1 
1 1 1 1 1 2 2 1 1 1 1 1 1 1 2 1 1 1 1 1 0 0 0 0 0 1 1 0 1 1 
2 2 2 2 2 2 1 1 1 0 1 1 1 2 2 1 1 2 2 2 0 0 0 1 1 1 1 1 1 2 
2 3 3 3 2 1 1 1 0 0 0 0 1 2 3 2 1 2 3 2 1 1 1 1 0 1 2 1 1 2 
